*******************************************************************************************
*******************************************************************************************
*******************************************************************************************
*******************************************************************************************
**###########******************************************************************************
**#.........#******************************************************************************
**#....@....#****##############*********##############*************************************
**#.........######............#********#..............#************************************
**#...&.......................#*******#................#****################***************
**################....&.......########.................######...............#****########**
*****************#....&....................&................................#####.......#**
*****************#............########.....&...........#####............................#**
*****************#............#*******#................#****##..............#####.......#**
*****************#............#********#..............#*******#########.....#****########**
*****************##############*********###############****************#####***************
*******************************************************************************************
*******************************************************************************************