*******************************************************************************************
*******************************************************************************************
**###########******************************************************************************
**#.........#******************************************************************************
**#....@....#****##############*********##############*************************************
**#....#....######......&.....#********#..............#************************************
**#....&......................#*******#............&...#****################***************
**################.....#......########......#..........######.....&.........#****########**
*****************#......#...................................................#####.......#**
*****************#.&..........########.................#####...&....................&...#**
*****************#......&.....#*******#...&.....#......#****##..........&...#####.......#**
*****************#............#********#..........&...#*******#########.....#****########**
*****************##############*********###############****************#####***************
*******************************************************************************************
*******************************************************************************************