*******************************************************************************************
*******************************************************************************************
**###########******************************************************************************
**#.......&.#******************************************************************************
**#....@....#****##############*********##############*************************************
**#....#....######......&.....#********#.&....#.......#************************************
**#....&......................#*******#............&...#****################***************
**################.....#...&..########......#..........######.....&.........#****########**
*****************#...#..#.......................#...........................#####.......#**
*****************#.&.....#....########.......#.........#####...&....................&...#**
*****************#......&.....#*******#...&.....#......#****##..........&...#####.......#**
*****************#............#********#..........&...#*******#########.....#****########**
*****************##############*********###############****************#####***************
*******************************************************************************************
*******************************************************************************************